   ____   __  __ _      _       _   ______ _           __  __   _                _        
  / __ \ / _|/ _(_)    (_)     | | |  ____(_)         |  \/  | | |              | |       
 | |  | | |_| |_ _  ___ _  __ _| | | |__   ___   _____| \  / | | |     ___  __ _| | _____ 
 | |  | |  _|  _| |/ __| |/ _` | | |  __| | \ \ / / _ \ |\/| | | |    / _ \/ _` | |/ / __|
 | |__| | | | | | | (__| | (_| | | | |    | |\ V /  __/ |  | | | |___|  __/ (_| |   <\__ \
  \____/|_| |_| |_|\___|_|\__,_|_| |_|    |_| \_/ \___|_|  |_| |______\___|\__,_|_|\_\___/

JOIN THE DISCORD !

    https://discord.gg/cUjU7Er2MM
                 or
           https://ofsl.tk

© Official FiveM - Support & Leaks